++++++++++++++++++++++++++++++
++------------++------------++
++-++++-+++++-++-+++++-++++-++
++-++++-+++++-++-+++++-++++-++
++-++++-+++++-++-+++++-++++-++
++--------------------------++
++-++++-++-++++++++-++-++++-++
++-++++-++-++++++++-++-++++-++
++------++----++----++------++
+++++++-+++++-++-+++++-+++++++
+++++++----------------+++++++
++++++++++++++++++++++++++++++